20 20
9 5 1 5 1 5 5 5 5 5 1 5 1 5 1 1 1 5 5 3 
8 7 12 3 12 1 5 5 5 7 12 3 8 7 14 14 8 1 3 14 
8 1 7 8 3 12 1 1 5 1 7 10 12 5 5 3 10 10 12 7 
10 8 3 10 8 7 10 12 3 8 3 12 5 1 7 10 10 12 1 7 
10 10 14 10 12 7 8 7 14 10 12 1 3 12 3 14 12 7 8 7 
10 8 7 12 1 7 12 1 7 8 7 10 8 3 12 5 1 7 12 7 
10 8 1 3 12 1 7 8 7 12 3 10 10 12 1 7 12 1 5 3 
10 10 10 8 3 12 3 12 5 7 14 10 8 7 8 5 3 8 7 10 
10 10 10 10 8 3 8 5 1 5 3 10 8 3 8 3 10 12 7 10 
10 14 10 14 14 10 8 7 12 3 14 14 14 14 10 10 8 1 3 14 
8 7 12 1 3 10 12 1 3 12 1 1 1 7 14 10 14 14 8 3 
8 1 7 10 14 8 7 14 12 7 10 14 12 5 3 8 1 3 10 10 
10 8 7 8 3 8 5 5 5 7 12 5 5 3 14 10 14 10 14 10 
10 8 3 14 14 12 5 1 1 1 5 1 7 12 7 12 7 8 7 14 
10 14 12 1 1 1 7 14 14 12 7 8 5 5 5 5 7 8 5 7 
8 1 7 10 14 8 5 1 1 1 7 12 5 5 5 5 7 12 1 3 
10 12 7 8 7 8 3 14 10 12 1 5 1 5 5 1 1 3 10 14 
8 1 3 8 7 10 8 3 8 7 8 3 8 1 7 14 14 14 8 7 
10 10 10 8 7 10 10 10 12 3 10 10 10 12 1 5 5 7 12 3 
14 14 14 12 7 14 14 12 7 14 14 14 12 7 12 5 5 5 7 14 


0 0 0 0 0 0 0 0 0 0 0 0 0 0 0 0 0 0 0 0 
0 0 0 0 0 0 5 0 0 0 0 0 0 0 0 0 0 4 0 0 
0 3 0 0 0 0 0 0 0 0 0 0 0 0 0 0 0 0 0 0 
0 0 0 0 8 0 0 0 0 0 0 0 0 0 0 0 0 0 0 0 
0 0 0 0 0 0 0 0 0 0 0 0 0 0 0 0 0 0 8 0 
0 0 0 0 0 0 0 0 0 0 0 0 0 0 0 0 0 0 4 0 
0 0 0 0 0 0 0 0 0 0 0 0 0 0 0 0 0 0 0 0 
0 9 0 0 0 0 0 0 0 6 0 0 0 0 0 0 0 0 0 0 
0 0 0 0 0 0 0 0 0 0 0 0 0 0 0 0 0 0 0 0 
0 0 0 0 0 0 0 0 6 1 0 6 0 0 0 0 0 0 0 0 
0 0 0 0 0 0 0 0 0 0 0 0 0 0 0 0 0 0 0 0 
0 0 0 0 5 0 0 0 0 0 0 0 0 0 0 0 0 0 9 0 
0 0 0 0 0 0 0 0 0 0 0 0 0 0 0 0 0 0 0 0 
0 0 0 0 0 0 0 0 0 0 0 0 0 0 0 0 0 0 0 0 
0 0 0 0 0 0 0 0 0 0 0 0 0 0 0 7 0 0 0 0 
0 0 0 0 0 0 0 0 0 0 0 0 0 0 0 0 0 0 0 0 
0 0 0 0 0 0 0 0 6 0 0 0 0 0 0 0 0 0 0 0 
0 4 0 0 0 0 0 0 0 0 0 0 9 0 0 0 0 0 3 0 
0 0 0 0 0 0 0 0 0 0 0 0 0 0 0 0 0 0 0 0 
0 0 0 0 0 0 0 5 0 0 0 0 0 0 0 0 0 0 0 0 

2 0 2